//MAP CONVERTED BY dmm2tgm.py THIS HEADER COMMENT PREVENTS RECONVERSION, DO NOT REMOVE
"a" = (
/turf/template_noop,
/area/template_noop)
"b" = (
/obj/item/extinguisher,
/obj/machinery/light{
	dir = 1;
	light_color = "#d1dfff"
	},
/turf/open/floor/mineral/titanium/tiled/blue,
/area/shuttle/escape)
"c" = (
/turf/open/floor/mineral/titanium/tiled/blue,
/area/shuttle/escape)
"f" = (
/obj/effect/spawner/structure/window/hollow/reinforced/middle{
	dir = 4
	},
/turf/open/floor/plating,
/area/shuttle/escape)
"g" = (
/obj/structure/shuttle/engine/propulsion/left{
	dir = 4
	},
/turf/open/floor/plating,
/area/space)
"h" = (
/obj/machinery/door/airlock/titanium{
	name = "Escape Shuttle"
	},
/obj/docking_port/mobile/emergency{
	dir = 1;
	dwidth = 6;
	height = 9;
	width = 18
	},
/turf/open/floor/plating,
/area/shuttle/escape)
"j" = (
/obj/machinery/light,
/turf/open/floor/mineral/titanium/tiled/blue,
/area/shuttle/escape)
"l" = (
/obj/structure/window/reinforced{
	dir = 4
	},
/turf/open/floor/mineral/titanium/tiled/blue,
/area/space)
"m" = (
/obj/item/storage/firstaid,
/obj/structure/window/reinforced{
	dir = 4
	},
/turf/open/floor/mineral/titanium/tiled/blue,
/area/space)
"r" = (
/obj/machinery/stasis,
/turf/open/floor/mineral/titanium/tiled/blue,
/area/space)
"s" = (
/turf/closed/wall/mineral/titanium,
/area/space)
"t" = (
/obj/item/crowbar,
/turf/open/floor/mineral/titanium/tiled/blue,
/area/shuttle/escape)
"u" = (
/obj/structure/chair{
	dir = 8
	},
/turf/open/floor/mineral/titanium/tiled/blue,
/area/shuttle/escape)
"v" = (
/turf/open/floor/mineral/titanium/tiled/blue,
/area/space)
"w" = (
/turf/closed/wall/mineral/titanium/overspace,
/area/space)
"x" = (
/obj/item/extinguisher,
/turf/open/floor/mineral/titanium/tiled/blue,
/area/shuttle/escape)
"y" = (
/obj/machinery/door/airlock/titanium{
	name = "Escape Shuttle"
	},
/turf/open/floor/plating,
/area/space)
"z" = (
/obj/item/tank/internals/oxygen,
/turf/open/floor/mineral/titanium/tiled/blue,
/area/shuttle/escape)
"A" = (
/turf/closed/wall/mineral/titanium/overspace,
/area/shuttle/escape)
"B" = (
/obj/structure/bed,
/turf/open/floor/mineral/titanium/tiled/blue,
/area/shuttle/escape)
"D" = (
/obj/machinery/computer/emergency_shuttle{
	dir = 4
	},
/turf/open/floor/mineral/titanium/tiled/blue,
/area/shuttle/escape)
"F" = (
/obj/structure/shuttle/engine/propulsion/right{
	dir = 4
	},
/turf/open/floor/plating,
/area/space)
"G" = (
/obj/machinery/door/window/eastleft{
	name = "Escape Shuttle Infirmary"
	},
/turf/open/floor/mineral/titanium/tiled/blue,
/area/shuttle/escape)
"H" = (
/obj/structure/window/reinforced,
/obj/item/extinguisher,
/obj/machinery/light{
	dir = 1;
	light_color = "#d1dfff"
	},
/turf/open/floor/mineral/titanium/tiled/blue,
/area/space)
"J" = (
/turf/closed/wall/mineral/titanium,
/area/shuttle/escape)
"K" = (
/obj/effect/spawner/structure/window/hollow/reinforced/middle,
/turf/open/floor/plating,
/area/shuttle/escape)
"M" = (
/obj/machinery/door/airlock/titanium{
	name = "Escape Shuttle"
	},
/turf/open/floor/plating,
/area/shuttle/escape)
"O" = (
/obj/item/storage/firstaid/toxin,
/obj/structure/window/reinforced{
	dir = 4
	},
/turf/open/floor/mineral/titanium/tiled/blue,
/area/space)
"Q" = (
/obj/structure/window/reinforced{
	dir = 4
	},
/turf/open/floor/mineral/titanium/tiled/blue,
/area/shuttle/escape)
"R" = (
/obj/item/radio,
/turf/open/floor/mineral/titanium/tiled/blue,
/area/shuttle/escape)
"T" = (
/obj/item/storage/firstaid/fire,
/obj/structure/window/reinforced{
	dir = 4
	},
/turf/open/floor/mineral/titanium/tiled/blue,
/area/space)
"V" = (
/obj/structure/window/reinforced{
	dir = 1
	},
/obj/structure/reagent_dispensers/watertank,
/obj/machinery/light,
/turf/open/floor/mineral/titanium/tiled/blue,
/area/space)
"X" = (
/obj/machinery/light{
	dir = 1;
	light_color = "#d1dfff"
	},
/turf/open/floor/mineral/titanium/tiled/blue,
/area/shuttle/escape)

(1,1,1) = {"
a
a
A
f
f
f
A
a
a
"}
(2,1,1) = {"
a
A
J
c
D
c
J
A
a
"}
(3,1,1) = {"
A
J
c
c
u
c
c
J
A
"}
(4,1,1) = {"
J
b
c
c
c
c
c
j
J
"}
(5,1,1) = {"
M
c
u
u
u
u
u
c
M
"}
(6,1,1) = {"
J
x
c
c
c
c
c
c
J
"}
(7,1,1) = {"
M
c
u
u
u
u
u
c
h
"}
(8,1,1) = {"
J
X
c
c
c
c
c
j
J
"}
(9,1,1) = {"
K
z
u
u
u
u
u
c
K
"}
(10,1,1) = {"
K
c
c
c
c
c
c
c
K
"}
(11,1,1) = {"
K
c
B
c
B
c
B
c
K
"}
(12,1,1) = {"
J
X
c
c
c
c
c
j
J
"}
(13,1,1) = {"
M
t
B
c
B
c
B
R
M
"}
(14,1,1) = {"
J
x
c
c
c
c
c
c
J
"}
(15,1,1) = {"
y
c
Q
G
Q
G
Q
c
y
"}
(16,1,1) = {"
s
H
r
v
r
v
r
V
s
"}
(17,1,1) = {"
w
s
m
l
O
l
T
s
w
"}
(18,1,1) = {"
a
w
F
g
s
F
g
w
a
"}
